{
  "010010101001": "0001",
  "010011006005": "0001",
  "030430203001": "0001",
  "030430203002": "0001",
  "030430203003": "0001",
  "051279902001": "0001",
  "160011310006": "0001",
  "400010101001": "0001",
  "600010202001": "0001",
  "600010202002": "0001",
  "600010202003": "0001",
  "600010202004": "0001",
  "600010202005": "0001",
  "600010202006": "0001"
}